NO ./img/bluestone.xpm
SO ./img/colorstone.xpm
WE ./img/eagle.xpm
EA ./img/redbrick.xpm

F 128,128,128
C 0,0,0

11111111111111111111111
10000000000000000000001
10000000000000000000001
10000000000000000000001
10000000000000000000001
10000000000000000000001
10000000000000000000001
10000000000000000000001
11111111111111111111111