NO ./img/bluestone.xpm
SO ./img/colorstone.xpm
WE ./img/eagle.xpm
EA ./img/redbrick.xpm

F 0,128,0
C 0,128,128

11111111
10000001
10000001
1000000111111111
1000000110000001
1001000110000001
1000000000000001
1010100110000001
1010100110000001
1000000111111111
100P0001
10000001
11111111