NO ./img/bluestone.xpm

        C             10,10,200  
    
                    SO ./img/colorstone.xpm
                F 250,200,100
    WE  ./img/eagle.xpm
        
        EA   ./img/redbrick.xpm

11   1      1
101 101    101     1111
11111111    1      10001
10000001            1111 
100W0001
1000000111111111 0
1000000110000001     1             
10010001100001011   101
1000000000001 1001   1
10101001100001001
1010100110000001
1000000111111111
10000001
10000001 
11111111

11111
10001
10001
11111