NO ./img/bluestone.xpm
SO ./img/colorstone.xpm
WE ./img/eagle.xpm
EA ./img/redbrick.xpm

F 128,128,128
C 0,0,0

11111111111111111
10101010000000001
10001001000000001
10010001000000011
1000P001000000001
11111111111111111